1111111111111
10010000000C1
1X0C011111001
10000111110H1
1P0V11E000001
1111111111111