111111111111111111
1C0x0C000000H000P1
1000H00000C00C00C1
10X1111100X00X00X1
10C11111v01C0C00C1
10x1111100111x0Vx1
10011111001111C001
100C11110011111001
1X00X1110011111X01
1Cv0C0C1EV11111C01
1x00x00x0011111x01
1C00C00C00000h0001
1P0000h00000C0x0C1
111111111111111111