11111111111111111111111
1000H000X0000C000v00P01
1010X101C010x1000010101
1010010C1010010VE01x101
1P0000h00C00CX0000000C1
11111111111111111111111