1111111111111111111111111
1000000000000C0C000000P01
1010010100100011000010101
10100100101010010E0010101
1P0000000C00C0000000000C1
1111111111111111111111111